1111111111111111111
1E00C00000000000001
1E00C00000000000001
1E00C00000000000001
1E00C00000000000001
1E00C00000000000001
1E00C00000000000001
1E00C00000000000001
1E00C00000000000001
1E00C00000000000001
1E00C00000000000001
1E00C00000000000001
1E00C00000000000001
1E00C00000000000001
1E00C00000000000001
1E00C00000000000001
1E00C00000000000001
1E000000000000000P1
1111111111111111111
