1111111111
1E0000C001
1P00000001
1111111111
