11111111111111111
1E00C000000000001
1E00C000000000001
1E00C000000000001
1E00C000000000001
1E00C000000000001
1E00C000000000001
1E00C000000000001
1E00C000000000001
1E00C000000000001
1E00C000000000001
1E00C000000000001
1E00C000000000001
1E00C000000000001
1E00C000000000001
1E00P000000000001
11111111111111111
