1111111111111111111
1C0000C000000000001
1E0000C000000000001
1E0000C000000000001
1E0000C000000000001
1E0000C000000000001
1E0000C000000000001
1P0000C000000000001
1E0000C000000000001
1E0000C000000000001
1E0000C000000000001
1E0000C000000000001
1E0000C000000000001
1E0000C000000000001
1000000000000000001
1111111111111111111
