11111111111111
10010000100001
1C0001M0001001
10010000100001
10M001000M1001
1PE100001000C1
11111111111111
