1111111111111111
1E0MC000000000C1
1M00M000M0000001
1000000M00000001
100000C000000001
100000M000000C01
100000M000000001
10000000M0000001
1000000000000001
100M000000000001
10000000000000C1
10001111100M0001
100011M110000001
100011111000M001
100C000M00000001
1C0P000000000C01
1111111111111111
