1111111111111111
1E0MC00000000001
1M00M000M0000001
1000000M00000001
100000C000000001
100000M000000C01
100000M000000001
10000000M0000001
1000000000000001
100M000000000001
1000000M000000C1
100C1110110M0001
100M11M111000001
100C11111C000001
100C000M00000001
1C0P000000000C01
1111111111111111
