1111111111
1E000C0001
100P000001
1111111111
